11111111111111111111
10000000000000000001
10111011110111111101
10000000000100000001
10111111010101111101
10000000010100000001
10010111010111111101
10110111010100010001
10100110011101110101
10100000000000000001
10111110111011111101
10000010000001000001
10111010110101011101
10000010000101000001
11111111111111111111
